X,X,X,X,X,X,X,X,X,X,X,X,X,X,X
X,1,_,O,b,b,b,b,b,b,b,O,_,4,X
X,_,X,b,X,b,X,b,X,b,X,b,X,_,X
X,O,b,b,b,b,b,b,b,b,b,b,b,O,X
X,b,X,b,X,b,X,b,X,b,X,b,X,b,X
X,b,b,b,b,b,b,b,b,b,b,b,b,b,X
X,b,X,b,X,b,X,b,X,b,X,b,X,b,X
X,b,b,b,b,b,b,b,b,b,b,b,b,b,X
X,b,X,b,X,b,X,b,X,b,X,b,X,b,X
X,O,b,b,b,b,b,b,b,b,b,b,b,O,X
X,_,X,b,X,b,X,b,X,b,X,b,X,_,X
X,3,_,O,b,b,b,b,b,b,b,O,_,2,X
X,X,X,X,X,X,X,X,X,X,X,X,X,X,X