X,X,X,X,X,X,X,X,X,X,X,X,X,X,X
X,1,_,s,b,b,b,b,b,b,b,s,_,4,X
X,_,X,b,X,b,X,b,X,b,X,b,X,_,X
X,s,b,b,b,b,b,b,b,b,b,b,b,s,X
X,b,X,b,X,b,X,b,X,b,X,b,X,b,X
X,b,b,b,b,b,b,b,b,b,b,b,b,b,X
X,b,X,b,X,b,X,b,X,b,X,b,X,b,X
X,b,b,b,b,b,b,b,b,b,b,b,b,b,X
X,b,X,b,X,b,X,b,X,b,X,b,X,b,X
X,s,b,b,b,b,b,b,b,b,b,b,b,s,X
X,_,X,b,X,b,X,b,X,b,X,b,X,_,X
X,3,_,s,b,b,b,b,b,b,b,s,_,2,X
X,X,X,X,X,X,X,X,X,X,X,X,X,X,X