X,X,X,X,X,X,X,X,X,X,X,X,X,X,X
X,1,_,_,_,_,_,_,_,_,_,_,_,4,X
X,_,X,_,X,_,X,_,X,_,X,_,X,_,X
X,b,_,_,_,_,_,b,_,_,_,_,_,_,X
X,b,X,_,X,_,X,b,X,_,X,_,X,_,X
X,b,_,_,_,_,_,b,_,_,_,_,_,_,X
X,b,X,_,X,_,X,b,X,_,X,_,X,_,X
X,b,_,_,_,_,_,b,_,_,_,_,_,_,X
X,b,X,_,X,_,X,b,X,_,X,_,X,_,X
X,b,_,_,_,_,_,b,_,_,_,_,_,_,X
X,_,X,_,X,_,X,_,X,_,X,_,X,_,X
X,3,_,_,_,b,b,b,b,b,b,b,_,2,X
X,X,X,X,X,X,X,X,X,X,X,X,X,X,X